Code	Place (RG Means ring)
GLY	CA
ALA	CB
VAL	CB
LEU	CB
MET	CB
ILE	CB
SER	CB
THR	CB
CYS	CB
ASN	CB
GLN	CB
LYS	NZ
ARG	CZ
ASP	CG
GLU	CD
PRO	CB
HIS	RG
PHE	CB
TYR	CB
TRP	CB
